SO   images/sand.xpm
R   960     540
NO     images/dirt.xpm
WE images/cobblestone.xpm
EA  images/bedrock.xpm

S images/diamond.xpm
F     163, 191, 126
C  110,197,233


        1111111111111111111111110
        1000000000110000002000001
        1011000001110000002200001
        1001000000000200220200001
111111111011000001110000000000001
100000000011000001110111112111111
11110111111111011100000010001
11110111111111011101010010001
11000000110101011100000012001
10020000000000001100000010001
1000000000000000110101001000111
11000001110101011111011110S01111
11110111 1110101 101111010201111
11111111 1111111 111111111111