R   981     540
NO     images/dirt.xpm
SO   images/sand.xpm
WE images/cobblestone.xpm
EA  images/bedrock.xpm

S images/diamond.xpm
F     163,191,126
C  110,197,233

11111111111111111111111111111111111111111111111111111111111111
10000000000000000000000000000000000000000000000000000000000001
10000000000000000000000000000000000000000000000000000000000001
10000000000000000000000000000000000000000000000000000000000001
10000000000000000000000000000000000000000000000000000000000001
10000000000000000000000000000000000000000000000000000000000001
100000000000000000000000000000W0000000000000000000000000000001
10000000000000000000000000000000000000000000000000000000000001
10000000000000000000020000000000000000000000000000000000000001
10000000000000000002000000000000000000000000000000000000000001
10000000000000000022222222222000000000000000000000000000000001
10000000000000000000000000000000000000000000000000000000000001
10000000000000000000000000000000000000000000000000000000000001
10000000000000000000000000000000000000000000000000000000000001
10000000000000000000000000000000000000000000000000000000000001
10000000000000000000000000000000000000000000000000000000000001
10000000000000000000000000000000000000000000000000000000000001
10000000000000000000000000000000000000000000000000000000000001
10000000000000000000000000000000000000000000000000000000000001
10000000000000000000000000000000000000000000000000000000000001
10000000000000000000000000000000000000000000000000000000000001
10000000000000000000000000000000000000000000000000000000000001
10000000000000000000000000000000000000000000000000000000000001
10000000000000000000000000000000000000000000000000000000000001
10000000000000000000000000000000000000000000000000000000000001
10000000000000000000000000000000000000000000000000000000000001
10000000000000000000000000000000000000000000000000000000000001
11111111111111111111111111111111111111111111111111111111111111